1111111111111111111111111111111111
1E00000000000000000000000000000001
1000010100100000101001000000010101
1C000100101010100010010000C0010101
10000P000000000000000000000000000
1111111111111111111111111111111111